1 24 24 24 24 24 24 24 24 24 24 7 2 6 1 1
1 24 24 24 24 24 24 24 24 24 1 7 2 6 1 1
1 1 1 24 24 24 24 24 24 24 24 7 2 6 1 1
1 1 1 1 24 24 24 24 24 24 1 7 2 6 1 1
1 11 9 9 9 9 9 9 9 9 9 10 2 6 24 24
1 7 2 2 2 2 2 2 2 2 2 2 2 6 24 24
1 7 2 3 4 4 4 4 4 4 4 4 4 13 24 24
1 7 2 6 0 1 1 1 0 0 0 0 24 24 24 24
1 7 2 6 1 1 1 0 0 16 17 17 17 17 17 17
1 7 2 6 1 1 0 0 0 19 14 15 14 14 15 15
1 7 2 6 1 1 0 0 16 27 14 15 14 14 15 14
1 7 2 6 1 1 0 0 19 15 14 15 15 15 14 14