23 18 18 18 18 18 18 18 18 18 18 18 18 18 18 18 18 18 18 18 18 24 8 3 7 1 1 1 1 1 1 1 1 1 1 1 1 1 1 1 1 1 8 3 7 1 1 1 1 1
25 29 18 18 18 18 18 18 18 18 18 18 18 19 19 19 18 18 18 18 18 24 8 3 7 1 1 1 1 1 1 1 1 1 1 1 1 1 1 1 1 1 8 3 7 1 1 1 1 1
16 25 29 18 18 18 18 18 18 18 18 18 18 19 19 19 18 18 18 18 18 24 8 3 7 1 1 1 1 1 1 1 1 1 1 1 1 1 1 1 1 1 8 3 7 1 1 1 1 1
16 16 25 29 18 18 19 19 18 18 18 18 18 18 18 18 18 18 18 18 18 24 8 3 7 1 1 1 1 1 1 1 1 1 1 1 1 1 1 1 1 1 8 3 7 1 1 1 1 1
16 16 16 23 18 18 19 19 18 28 26 26 26 26 26 26 26 26 26 26 26 27 8 3 7 1 1 1 1 1 1 1 1 1 1 1 1 1 1 1 1 1 8 3 7 1 1 1 1 1
16 16 16 23 18 18 18 18 18 24 2 2 12 10 10 10 10 10 10 10 10 10 11 3 7 1 1 1 1 1 1 1 1 1 1 1 1 1 1 1 1 1 8 3 7 1 1 1 1 1
16 16 16 23 18 18 18 18 18 24 2 33 8 3 3 3 3 3 3 3 3 3 3 3 7 1 1 1 1 1 1 1 1 1 1 1 1 1 1 1 1 1 8 3 7 1 1 1 1 1
16 16 16 23 19 19 18 18 18 24 2 2 14 5 5 5 6 3 4 5 5 5 6 3 7 1 1 1 1 1 1 1 1 1 1 1 1 1 1 1 1 1 8 3 7 1 1 1 1 1
16 16 16 23 19 19 19 18 18 30 21 21 21 21 21 22 8 3 7 16 16 16 8 3 7 1 1 1 1 1 1 1 1 1 1 1 1 1 1 1 1 1 8 3 7 1 1 1 1 1
16 16 16 23 18 18 18 18 18 18 18 18 18 19 19 24 8 3 7 16 16 16 8 3 7 1 1 1 1 1 1 1 1 1 1 1 1 1 1 1 1 1 8 3 7 1 1 1 1 1
16 16 16 25 26 26 26 26 26 26 26 26 26 26 26 27 8 3 7 16 16 16 8 3 7 1 1 1 1 1 1 1 1 1 1 1 1 1 1 1 1 1 8 3 7 1 1 1 1 1
10 10 10 10 10 10 10 10 10 10 10 10 10 10 10 10 11 3 9 10 10 10 11 3 9 10 10 10 10 10 10 10 10 10 10 10 10 10 10 10 10 10 11 3 7 1 1 1 1 1
3 3 3 3 3 3 3 3 3 3 3 3 3 3 3 3 3 3 3 3 3 3 3 3 3 3 3 3 3 3 3 3 3 3 3 3 3 3 3 3 3 3 3 3 7 1 1 1 1 1
5 5 5 5 5 5 5 5 5 5 5 5 5 5 5 5 5 5 5 5 5 5 5 5 5 5 5 5 5 5 5 5 5 5 5 5 5 5 5 5 5 5 6 3 7 1 1 1 1 1
1 1 1 1 1 1 1 1 1 1 1 1 1 1 1 1 1 1 1 1 1 1 1 1 1 1 1 1 1 1 1 1 1 1 1 1 1 1 1 1 1 1 8 3 7 1 1 1 1 1
1 1 1 1 1 1 1 1 1 1 1 1 1 1 1 1 1 1 1 1 1 1 1 1 1 1 1 1 1 1 1 1 1 1 1 1 1 1 1 1 1 1 8 3 7 1 1 1 1 1
1 1 1 1 1 1 1 1 1 1 1 1 1 1 1 1 1 1 1 1 1 1 1 1 1 1 1 1 1 1 1 1 1 1 1 1 1 1 1 1 1 1 8 3 7 1 1 1 1 1
1 1 1 1 1 1 1 1 1 1 1 1 1 1 1 1 1 1 1 1 1 1 1 1 1 1 1 1 1 1 1 1 1 1 1 1 1 1 1 1 1 1 8 3 7 1 1 1 1 1
1 1 1 1 1 1 1 1 1 1 1 1 1 1 1 1 1 1 1 1 1 1 1 1 1 1 1 1 1 1 1 1 1 1 1 1 1 1 1 1 1 1 8 3 7 1 1 1 1 1
1 1 1 1 1 1 1 20 21 21 22 1 1 1 1 1 1 1 1 1 1 1 1 1 1 1 1 1 1 1 1 1 1 1 1 1 1 1 1 1 1 1 8 3 7 1 1 1 1 1
1 1 1 1 1 1 20 31 18 18 24 1 1 1 1 1 1 1 1 1 1 1 1 1 1 1 1 1 1 1 1 1 1 1 1 1 1 1 1 1 1 1 8 3 7 1 1 1 1 1
1 1 1 1 1 20 31 18 18 18 24 1 1 1 1 1 1 1 1 1 1 1 1 1 1 1 1 1 1 1 1 1 1 1 1 1 1 1 1 1 1 1 8 3 7 1 1 1 1 1
1 1 1 20 21 31 18 18 18 18 24 1 1 1 1 1 1 1 1 1 1 1 1 1 1 1 1 1 1 1 1 1 1 1 1 1 1 1 1 1 1 1 8 3 9 10 10 13 1 1
1 1 1 23 18 18 19 19 19 18 30 21 21 22 1 1 1 1 1 1 1 1 1 1 1 1 1 1 1 1 1 1 1 1 1 1 1 1 1 1 1 1 8 3 3 3 3 7 1 1
1 1 1 23 18 18 19 19 19 18 18 18 18 30 22 1 1 1 1 1 1 1 1 1 1 1 1 1 1 1 1 1 1 1 1 1 1 1 1 1 1 1 14 5 5 6 3 7 1 1
21 21 21 31 18 19 19 19 18 18 18 18 19 19 24 1 1 1 1 1 1 1 1 1 1 1 1 1 1 1 1 1 1 1 1 1 1 1 1 1 1 1 1 1 1 8 3 7 1 1
18 18 18 18 18 18 18 18 18 18 18 18 19 19 30 21 21 21 21 21 21 21 21 21 21 21 21 21 21 21 21 21 21 21 22 1 1 1 1 1 1 1 1 1 1 8 3 7 1 1
18 18 18 18 18 18 18 18 18 18 18 18 18 18 18 18 18 18 18 18 18 18 18 18 18 18 18 18 18 18 18 18 18 18 24 1 1 1 1 1 1 1 1 1 1 8 3 7 1 1
18 18 18 18 18 18 18 18 18 18 18 18 18 18 18 18 18 18 18 18 18 18 18 18 18 18 18 18 18 18 18 18 18 18 24 1 1 1 1 1 1 1 1 1 1 8 3 7 1 1
18 18 18 18 18 18 18 18 18 18 18 18 18 18 18 19 19 18 18 18 18 18 18 18 18 18 18 18 18 18 18 18 18 18 24 1 1 1 1 1 1 1 1 1 1 8 3 7 1 1
18 18 18 18 18 18 18 18 18 18 18 18 18 18 18 19 19 18 18 18 18 18 18 18 18 18 18 18 18 18 18 18 18 18 24 1 1 1 1 1 1 1 1 1 1 8 3 7 1 1
18 18 18 18 18 18 18 18 18 18 18 18 18 18 18 18 18 18 18 18 18 18 18 18 18 18 18 18 18 18 18 18 18 28 27 2 1 1 1 1 1 1 1 1 1 8 3 9 10 10
18 18 18 18 18 18 18 18 18 18 18 18 18 18 18 18 18 18 18 18 18 18 18 18 18 18 18 18 18 18 18 18 28 27 2 2 1 1 1 1 1 1 1 1 1 8 3 3 3 3
18 18 18 18 18 18 18 18 18 18 18 18 18 18 18 18 18 18 18 18 18 18 18 18 18 18 18 18 18 18 18 28 27 2 2 2 1 1 1 1 1 1 1 1 1 8 3 4 5 5
18 18 18 18 18 18 18 18 18 18 18 18 18 18 18 18 18 18 18 18 18 18 18 18 18 18 18 18 18 18 28 27 2 2 2 2 1 1 1 1 1 1 1 1 1 8 3 7 1 1
18 18 18 18 18 18 18 18 18 18 18 18 18 18 18 18 18 18 18 18 18 18 18 18 18 18 18 18 18 28 27 2 2 2 2 2 1 1 1 1 1 1 1 1 1 8 3 7 1 1
18 18 18 18 18 18 18 18 18 18 18 18 18 18 18 18 18 18 18 18 18 18 18 18 18 18 18 18 28 27 2 2 2 2 2 2 1 1 1 1 1 1 1 1 1 8 3 7 1 1
18 18 18 18 18 18 18 18 18 18 18 18 18 18 18 18 18 18 18 18 18 18 18 18 18 18 18 28 27 2 2 2 2 2 2 1 2 1 1 1 1 1 1 1 1 8 3 7 1 1
18 18 18 18 18 18 18 18 18 18 18 18 18 18 18 18 18 18 18 18 18 18 18 18 18 18 28 27 2 2 2 2 2 2 2 1 1 1 1 1 1 1 1 1 1 8 3 7 1 1
18 18 18 18 18 18 18 18 18 18 18 18 18 18 18 18 18 18 18 18 18 18 18 18 18 28 27 2 2 2 2 2 2 2 2 12 10 10 10 10 10 10 10 10 10 11 3 7 1 1
18 18 18 18 18 18 18 18 18 18 18 18 18 18 18 18 18 18 18 18 18 18 18 18 18 24 2 2 2 2 2 2 2 2 2 8 3 3 3 3 3 3 3 3 3 3 3 7 1 1
18 18 18 18 18 18 18 18 18 18 18 18 18 18 18 18 18 18 18 18 18 18 18 18 18 30 22 2 2 2 2 2 2 2 2 14 5 5 5 5 5 6 3 4 5 5 5 15 1 1
18 18 18 18 18 18 18 18 18 18 18 18 18 18 18 18 18 18 18 18 18 18 18 18 18 18 24 2 2 2 2 2 2 2 2 2 2 2 2 2 2 8 3 7 1 1 1 1 1 1
18 18 18 18 18 18 18 18 18 18 18 18 18 18 18 18 18 18 18 18 18 18 18 18 18 18 30 21 21 21 21 22 2 2 16 2 2 2 2 2 2 8 3 7 1 1 1 1 1 1
18 18 18 18 18 18 18 18 18 18 18 18 18 18 18 18 18 18 18 18 18 18 18 18 18 18 18 18 18 18 18 30 22 2 16 2 2 2 2 2 2 8 3 7 1 1 1 1 1 1
18 18 18 18 18 18 18 18 18 18 18 18 18 18 18 18 18 18 18 18 18 18 18 18 18 18 18 18 18 18 18 18 30 22 16 2 2 2 2 2 2 8 3 7 1 1 1 1 1 1
18 18 18 18 18 18 18 18 18 18 18 18 18 18 18 18 18 18 18 18 18 18 18 18 18 18 18 18 18 18 18 18 18 24 16 2 2 2 2 2 2 8 3 7 1 1 1 1 1 1
18 18 18 18 18 18 18 18 18 18 18 18 18 18 18 18 18 18 18 18 18 18 18 18 18 18 18 18 18 18 18 18 18 30 22 2 2 2 2 2 2 8 3 7 1 1 1 1 1 1
18 18 18 18 18 18 18 18 18 18 18 18 18 18 18 18 18 18 18 18 18 18 18 18 18 18 18 18 18 18 18 18 18 18 24 2 2 2 2 2 2 8 3 7 1 1 1 1 1 1
18 18 18 18 18 18 18 18 18 18 18 18 18 18 18 18 18 18 18 18 18 18 18 18 18 18 18 18 18 18 18 18 18 18 24 2 2 2 2 2 2 8 3 7 1 1 1 1 1 1